NO ./textures/brick-texture-png-23885.png
SO ./textures/brick-texture-png-23868.png
WE ./textures/brick-texture-png-23873.png
EA ./textures/brick-texture-png-23887.png

C 115,215,225
F 74,160,44

        1111111111111111111111111
        1000000000110000000000001
        1011000001110000000000001
        1001000000000000000000001
111111111011000001110000000000001
100000000011000001110111111111111
11110111111111011100000010001
11113111111111011101010010001
11000000110101011100000030001
1000N000000000001100000010001
30000000000000001101010010001
110000011101010111110111100111
11110111 1110101 101111010001
11111111 1111111 111111111111
