1111111111111111111111111
1110001111100000000000011
1011000001110000010000001
1001001100000000000000001
1110001110110000011100001
100000N000110000001101111
10000000000000001 1101001
11000001110101011 1101101
11111111111111111 1111111