NO /Users/tyi/Documents/practicing/cub3d/test_map.cub
WE /Users/tyi/Documents/practicing/cub3d/test_map.cub
EA /Users/tyi/Documents/practicing/cub3d/test_map.cub

SO /Users/tyi/Documents/practicing/cub3d/test_map.cub

C 255,255,255

F 0,0,0

       111111111111111111
1111111111110000000000001
1011000001110000010000001
10010011000000000000000011111
1110001110110000011100001
10000N0001100000111011111
1000000000000000110101001
1100000111010101111101111
1111111111111111111111111
