1111111111111111111111111
1000000111110000000000001
1011000001110000010000001
1001001100000000000000001
1110001110110000011100001
100000N000110000011101111
1000000000000000110101001
1100000111010101111101101
1111111111111111111111111