NO /Users/tyi/Documents/practicing/cub3d/test_map.cub
WE /Users/tyi/Documents/practicing/cub3d/test_map.cub
EA /Users/tyi/Documents/practicing/cub3d/test_map.cub

C 255,255,255
SO /Users/tyi/Documents/practicing/cub3d/test_map.cub


F 0,0,1


1111111111111111111111111
1000000111110000000000001
1011000001110000010000001
1001001100000000000000001
1110001110110000011100001
100000N000110000011101111
1000000000000000110101001
1100000111010101111101111
1111111111111111111111111